20 20
0 2
## #################
#                  #
#                  #
#    ##########    #
#    #        #    #
#    #        #    #
#    #        #    #
#    #        #    #
#    #        #    #
#    #        #    #
#    #        #    #
#    #        #    #
#    #        #    #
#    #        #    #
#    #        #    #
#    #        #    #
#    #        #    #
#    ##########    #
#                  #
####################